ablutophobia: fear of washing or bathing
acarophobia: fear of itching or of the insects that cause itching
acerophobia: fear of sourness
achluophobia: fear of darkness
acousticophobia: fear of noise
acrophobia: fear of heights
aerophobia: fear of drafts, air swallowing, or airbourne noxious substances
aeroacrophobia: fear of open high places
aeronausiphobia: fear of vomiting secondary to airsickness
agateophobia: fear of insanity
agliophobia: fear of pain
agoraphobia: fear of open spaces or of being in crowded, public places like markets fear of leaving a safe place
agraphobia: fear of sexual abuse
agrizoophobia: fear of wild animals
agyrophobia: fear of streets or crossing the street
aichmophobia: fear of needles or pointed objects
ailurophobia: fear of cats
albuminurophobia: fear of kidney disease
alektorophobia: fear of chickens
algophobia: fear of pain
alliumphobia: fear of garlic
allodoxaphobia: fear of opinions
altophobia: fear of heights
amathophobia: fear of dust
amaxophobia: fear of riding in a car
ambulophobia: fear of walking
amnesiphobia: fear of amnesia
amychophobia: fear of scratches or being scratched
anablephobia: fear of looking up
ancraophobia: fear of wind (anemophobia)
androphobia: fear of men
anemophobia: fear of air drafts or wind (ancraophobia) 
anginophobia: fear of angina, choking or narrowness
anglophobia: fear of england or english culture, etc
angrophobia : fear of anger or of becoming angry
ankylophobia: fear of immobility of a joint
anthrophobia or anthophobia: fear of flowers
anthropophobia: fear of people or society
antlophobia: fear of floods
anuptaphobia: fear of staying single
apeirophobia: fear of infinity
aphenphosmphobia: fear of being touched (haphephobia)
apiphobia: fear of bees
apotemnophobia: fear of persons with amputations
arachibutyrophobia: fear of peanut butter sticking to the roof of the mouth
arachnephobia or arachnophobia: fear of spiders
arithmophobia: fear of numbers
arrhenphobia: fear of men
arsonphobia: fear of fire
asthenophobia: fear of fainting or weakness
astraphobia or astrapophobia: fear of thunder and lightning (ceraunophobia, keraunophobia)
astrophobia: fear of stars or celestial space
asymmetriphobia: fear of asymmetrical things
ataxiophobia: fear of ataxia (muscular incoordination)
ataxophobia: fear of disorder or untidiness
atelophobia: fear of imperfection
atephobia: fear of ruin or ruins
athazagoraphobia: fear of being forgotton or ignored or forgetting
atomosophobia: fear of atomic explosions
atychiphobia: fear of failure
aulophobia: fear of flutes
aurophobia: fear of gold
auroraphobia: fear of northern lights
autodysomophobia: fear of one that has a vile odor
automatonophobia: fear of ventriloquist's dummies, animatronic creatures, wax statues - anything that falsly represents a sentient being
automysophobia: fear of being dirty
autophobia: fear of being alone or of oneself
aviophobia or aviatophobia: fear of flying
bacillophobia: fear of microbes
bacteriophobia: fear of bacteria
ballistophobia: fear of missiles or bullets
bolshephobia: fear of bolsheviks
barophobia: fear of gravity
basophobia or basiphobia: inability to stand fear of walking or falling
bathmophobia: fear of stairs or steep slopes
bathophobia: fear of depth
batophobia: fear of heights or being close to high buildings
batrachophobia: fear of amphibians, such as frogs, newts, salamanders, etc
belonephobia: fear of pins and needles (aichmophobia)
bibliophobia: fear of books
blennophobia: fear of slime
bogyphobia: fear of bogeys or the bogeyman
botanophobia: fear of plants
bromidrosiphobia or bromidrophobia: fear of body smells
brontophobia: fear of thunder and lightning
bufonophobia: fear of toads
cacophobia: fear of ugliness
cainophobia or cainotophobia: fear of newness, novelty
caligynephobia: fear of beautiful women
cancerophobia or carcinophobia: fear of cancer
cardiophobia: fear of the heart
carnophobia: fear of meat
catagelophobia: fear of being ridiculed
catapedaphobia: fear of jumping from high and low places
cathisophobia: fear of sitting
catoptrophobia: fear of mirrors
cenophobia or centophobia: fear of new things or ideas
ceraunophobia or keraunophobia: fear of thunder and lightning(astraphobia, astrapophobia)
chaetophobia: fear of hair
cheimaphobia or cheimatophobia: fear of cold(frigophobia, psychophobia)
chemophobia: fear of chemicals or working with chemicals
cherophobia: fear of gaiety
chionophobia: fear of snow
chiraptophobia: fear of being touched
chirophobia: fear of hands
chiroptophobia: fear of bats
cholerophobia: fear of anger or the fear of cholera
chorophobia: fear of dancing
chrometophobia or chrematophobia: fear of money
chromophobia or chromatophobia: fear of colors
chronophobia: fear of time
chronomentrophobia: fear of clocks
cibophobia: fear of food(sitophobia, sitiophobia)
claustrophobia: fear of confined spaces
cleithrophobia or cleisiophobia: fear of being locked in an enclosed place
cleptophobia: fear of stealing
climacophobia: fear of stairs, climbing, or of falling downstairs
clinophobia: fear of going to bed
clithrophobia or cleithrophobia: fear of being enclosed
cnidophobia: fear of stings
cometophobia: fear of comets
coimetrophobia: fear of cemeteries
coitophobia: fear of coitus
contreltophobia: fear of sexual abuse
coprastasophobia: fear of constipation
coprophobia: fear of feces
consecotaleophobia: fear of chopsticks
coulrophobia: fear of clowns
counterphobia: the preference by a phobic for fearful situations
cremnophobia: fear of precipices
cryophobia: fear of extreme cold, ice or frost
crystallophobia: fear of crystals or glass
cyberphobia: fear of computers or working on a computer
cyclophobia: fear of bicycles
cymophobia or kymophobia: fear of waves or wave like motions
cynophobia: fear of dogs or rabies
cypridophobia: fear of prostitutes or venereal disease
decidophobia: fear of making decisions
defecaloesiophobia: fear of painful bowels movements
deipnophobia: fear of dining or dinner conversations
dementophobia: fear of insanity
demonophobia or daemonophobia: fear of demons
demophobia: fear of crowds (agoraphobia)
dendrophobia: fear of trees
dentophobia: fear of dentists
dermatophobia: fear of skin lesions
dermatosiophobia or dermatophobia: fear of skin disease
dextrophobia: fear of objects at the right side of the body
diabetophobia: fear of diabetes
didaskaleinophobia: fear of going to school
dikephobia: fear of justice
dinophobia: fear of dizziness or whirlpools
diplophobia: fear of double vision
dipsophobia: fear of drinking
dishabiliophobia: fear of undressing in front of someone
disposophobia: fear of throwing stuff out hoarding
domatophobia: fear of houses or being in a house(eicophobia, oikophobia)
doraphobia: fear of fur or skins of animals
doxophobia: fear of expressing opinions or of receiving praise
dromophobia: fear of crossing streets
dutchphobia: fear of the dutch
dysmorphophobia: fear of deformity
dystychiphobia: fear of accidents
ecclesiophobia: fear of church
ecophobia: fear of home
eicophobia: fear of home surroundings(domatophobia, oikophobia)
eisoptrophobia: fear of mirrors or of seeing oneself in a mirror
electrophobia: fear of electricity
eleutherophobia: fear of freedom
elurophobia: fear of cats (ailurophobia)
emetophobia: fear of vomiting
enetophobia: fear of pins
enochlophobia: fear of crowds
enosiophobia or enissophobia: fear of having committed an unpardonable sin or of criticism
entomophobia: fear of insects
eosophobia: fear of dawn or daylight
ephebiphobia: fear of teenagers
epistaxiophobia: fear of nosebleeds
epistemophobia: fear of knowledge
equinophobia: fear of horses
eremophobia: fear of being oneself or of lonliness
ereuthrophobia: fear of blushing
ergasiophobia: 1) fear of work or functioning 2) surgeon's fear of operating
ergophobia: fear of work
erotophobia: fear of sexual love or sexual questions
euphobia: fear of hearing good news
eurotophobia: fear of female genitalia
erythrophobia or erytophobia: 1) fear of redlights 2) blushing 3) red
febriphobia or fibriphobia or fibriophobia: fear of fever
felinophobia: fear of cats (ailurophobia, elurophobia, galeophobia, gatophobia)
francophobia: fear of france or french culture (gallophobia, galiophobia)
frigophobia: fear of cold or cold things(cheimaphobia, cheimatophobia, psychrophobia)
galeophobia or gatophobia: fear of cats
gallophobia or galiophobia: fear france or french culture (francophobia) 
gamophobia: fear of marriage
geliophobia: fear of laughter
gelotophobia: fear of being laughed at
geniophobia: fear of chins
genophobia: fear of sex
genuphobia: fear of knees
gephyrophobia or gephydrophobia: fear of crossing bridges
germanophobia: fear of germany or german culture
gerascophobia: fear of growing old
gerontophobia: fear of old people or of growing old
geumaphobia or geumophobia: fear of taste
glossophobia: fear of speaking in public or of trying to speak
gnosiophobia: fear of knowledge
graphophobia: fear of writing or handwriting
gymnophobia: fear of nudity
gynephobia or gynophobia: fear of women
hadephobia: fear of hell
hagiophobia: fear of saints or holy things
hamartophobia: fear of sinning
haphephobia or haptephobia: fear of being touched
harpaxophobia: fear of being robbed
hedonophobia: fear of feeling pleasure
heliophobia: fear of the sun
hellenologophobia: fear of greek terms or complex scientific terminology
helminthophobia: fear of being infested with worms
hemophobia or hemaphobia or hematophobia: fear of blood
heresyphobia or hereiophobia: fear of challenges to official doctrine or of radical deviation
herpetophobia: fear of reptiles or creepy, crawly things
heterophobia: fear of the opposite sex (sexophobia)
hexakosioihexekontahexaphobia: fear of the number 666
hierophobia: fear of priests or sacred things
hippophobia: fear of horses
hippopotomonstrosesquipedaliophobia: fear of long words
hobophobia: fear of bums or beggars
hodophobia: fear of road travel
hormephobia: fear of shock
homichlophobia: fear of fog
homilophobia: fear of sermons
hominophobia: fear of men
homophobia: fear of sameness, monotony or of homosexuality or of becoming homosexual
hoplophobia: fear of firearms
hydrargyophobia: fear of mercurial medicines
hydrophobia: fear of water or of rabies
hydrophobophobia: fear of rabies
hyelophobia or hyalophobia: fear of glass
hygrophobia: fear of liquids, dampness, or moisture
hylephobia: fear of materialism or the fear of epilepsy
hylophobia: fear of forests
hypengyophobia or hypegiaphobia: fear of responsibility
hypnophobia: fear of sleep or of being hypnotized
hypsiphobia: fear of height
iatrophobia: fear of going to the doctor or of doctors
ichthyophobia: fear of fish
ideophobia: fear of ideas
illyngophobia: fear of vertigo or feeling dizzy when looking down
iophobia: fear of poison
insectophobia : fear of insects
isolophobia: fear of solitude, being alone
isopterophobia: fear of termites, insects that eat wood
ithyphallophobia: fear of seeing, thinking about or having an erect penis
japanophobia: fear of japanese
judeophobia: fear of jews
kainolophobia or kainophobia: fear of anything new, novelty
kakorrhaphiophobia: fear of failure or defeat
katagelophobia: fear of ridicule
kathisophobia: fear of sitting down
katsaridaphobia: fear of cockroaches
kenophobia: fear of voids or empty spaces
keraunophobia or ceraunophobia: fear of thunder and lightning(astraphobia, astrapophobia)
kinetophobia or kinesophobia: fear of movement or motion
kleptophobia: fear of stealing
koinoniphobia: fear of rooms
kolpophobia: fear of genitals, particularly female
kopophobia: fear of fatigue
koniophobia: fear of dust (amathophobia)
kosmikophobia: fear of cosmic phenomenon
kymophobia: fear of waves (cymophobia)
kynophobia: fear of rabies
kyphophobia: fear of stooping
lachanophobia: fear of vegetables
laliophobia or lalophobia: fear of speaking
leprophobia or lepraphobia: fear of leprosy
leukophobia: fear of the color white
levophobia: fear of things to the left side of the body
ligyrophobia: fear of loud noises
lilapsophobia: fear of tornadoes and hurricanes
limnophobia: fear of lakes
linonophobia: fear of string
liticaphobia: fear of lawsuits
lockiophobia: fear of childbirth
logizomechanophobia: fear of computers
logophobia: fear of words
luiphobia: fear of lues, syphillis
lutraphobia: fear of otters
lygophobia: fear of darkness
lyssophobia: fear of rabies or of becoming mad
macrophobia: fear of long waits
mageirocophobia: fear of cooking
maieusiophobia: fear of childbirth
malaxophobia: fear of love play (sarmassophobia)
maniaphobia: fear of insanity
mastigophobia: fear of punishment
mechanophobia: fear of machines
medomalacuphobia: fear of losing an erection
medorthophobia: fear of an erect penis
megalophobia: fear of large things
melissophobia: fear of bees
melanophobia: fear of the color black
melophobia: fear or hatred of music
meningitophobia: fear of brain disease
menophobia: fear of menstruation
merinthophobia: fear of being bound or tied up
metallophobia: fear of metal
metathesiophobia: fear of changes
meteorophobia: fear of meteors
methyphobia: fear of alcohol
metrophobia: fear or hatred of poetry
microbiophobia: fear of microbes (bacillophobia)
microphobia: fear of small things
misophobia or mysophobia: fear of being contaminated with dirt or germs
mnemophobia: fear of memories
molysmophobia or molysomophobia: fear of dirt or contamination
monophobia: fear of solitude or being alone
monopathophobia: fear of definite disease
motorphobia: fear of automobiles
mottephobia: fear of moths
musophobia or muriphobia: fear of mice
mycophobia: fear or aversion to mushrooms
mycrophobia: fear of small things
myctophobia: fear of darkness
myrmecophobia: fear of ants
mythophobia: fear of myths or stories or false statements
myxophobia: fear of slime (blennophobia)
nebulaphobia: fear of fog (homichlophobia)
necrophobia: fear of death or dead things
nelophobia: fear of glass
neopharmaphobia: fear of new drugs
neophobia: fear of anything new
nephophobia: fear of clouds
noctiphobia: fear of the night
nomatophobia: fear of names
nosocomephobia: fear of hospitals
nosophobia or nosemaphobia: fear of becoming ill
nostophobia: fear of returning home
novercaphobia: fear of your step-mother
nucleomituphobia: fear of nuclear weapons
nudophobia: fear of nudity
numerophobia: fear of numbers
nyctohylophobia: fear of dark wooded areas or of forests at night
nyctophobia: fear of the dark or of night
obesophobia: fear of gaining weight(pocrescophobia)
ochlophobia: fear of crowds or mobs
ochophobia: fear of vehicles
octophobia : fear of the figure 8
odontophobia: fear of teeth or dental surgery
odynophobia or odynephobia: fear of pain (algophobia)
oenophobia: fear of wines
oikophobia: fear of home surroundings, house(domatophobia, eicophobia)
olfactophobia: fear of smells
ombrophobia: fear of rain or of being rained on
ommetaphobia or ommatophobia: fear of eyes
omphalophobia: fear of belly buttons
oneirophobia: fear of dreams
oneirogmophobia: fear of wet dreams
onomatophobia: fear of hearing a certain word or of names
ophidiophobia: fear of snakes (snakephobia)
ophthalmophobia: fear of being stared at
opiophobia: fear medical doctors experience of prescribing needed pain medications for patients
optophobia: fear of opening one's eyes
ornithophobia: fear of birds
orthophobia: fear of property
osmophobia or osphresiophobia: fear of smells or odors
ostraconophobia: fear of shellfish
ouranophobia or uranophobia: fear of heaven
pagophobia: fear of ice or frost
panthophobia: fear of suffering and disease
panophobia or pantophobia: fear of everything
papaphobia: fear of the pope
papyrophobia: fear of paper
paralipophobia: fear of neglecting duty or responsibility
paraphobia: fear of sexual perversion
parasitophobia: fear of parasites
paraskavedekatriaphobia: fear of friday the 13th
parthenophobia: fear of virgins or young girls
pathophobia: fear of disease
patroiophobia: fear of heredity
parturiphobia: fear of childbirth
peccatophobia: fear of sinning or imaginary crimes
pediculophobia: fear of lice
pediophobia: fear of dolls
pedophobia: fear of children
peladophobia: fear of bald people
pellagrophobia: fear of pellagra
peniaphobia: fear of poverty
pentheraphobia: fear of mother-in-law (novercaphobia)
phagophobia: fear of swallowing or of eating or of being eaten
phalacrophobia: fear of becoming bald
phallophobia: fear of a penis, esp erect
pharmacophobia: fear of taking medicine
phasmophobia: fear of ghosts
phengophobia: fear of daylight or sunshine
philemaphobia or philematophobia: fear of kissing
philophobia: fear of falling in love or being in love
philosophobia: fear of philosophy
phobophobia: fear of phobias
photoaugliaphobia: fear of glaring lights
photophobia: fear of light
phonophobia: fear of noises or voices or one's own voice; of telephones
phronemophobia: fear of thinking
phthiriophobia: fear of lice (pediculophobia)
phthisiophobia: fear of tuberculosis
placophobia: fear of tombstones
plutophobia: fear of wealth
pluviophobia: fear of rain or of being rained on
pneumatiphobia: fear of spirits
pnigophobia or pnigerophobia: fear of choking of being smothered
pocrescophobia: fear of gaining weight (obesophobia)
pogonophobia: fear of beards
poliosophobia: fear of contracting poliomyelitis
politicophobia: fear or abnormal dislike of politicians
polyphobia: fear of many things
poinephobia: fear of punishment
ponophobia: fear of overworking or of pain
porphyrophobia: fear of the color purple
potamophobia: fear of rivers or running water
potophobia: fear of alcohol
pharmacophobia: fear of drugs
proctophobia: fear of rectums
prosophobia: fear of progress
psellismophobia: fear of stuttering
psychophobia: fear of mind
psychrophobia: fear of cold
pteromerhanophobia: fear of flying
pteronophobia: fear of being tickled by feathers
pupaphobia : fear of puppets
pyrexiophobia: fear of fever
pyrophobia: fear of fire
radiophobia: fear of radiation, x-rays
ranidaphobia: fear of frogs
rectophobia: fear of rectum or rectal diseases
rhabdophobia: fear of being severely punished or beaten by a rod, or of being severely criticized also fear of magic(wand)
rhypophobia: fear of defecation
rhytiphobia: fear of getting wrinkles
rupophobia: fear of dirt
russophobia: fear of russians
samhainophobia: fear of halloween
sarmassophobia: fear of love play (malaxophobia)
satanophobia: fear of satan
scabiophobia: fear of scabies
scatophobia: fear of fecal matter
scelerophibia: fear of bad men, burglars
sciophobia sciaphobia: fear of shadows
scoleciphobia: fear of worms
scolionophobia: fear of school
scopophobia or scoptophobia: fear of being seen or stared at
scotomaphobia: fear of blindness in visual field
scotophobia: fear of darkness (achluophobia)
scriptophobia: fear of writing in public
selachophobia: fear of sharks
selaphobia: fear of light flashes
selenophobia: fear of the moon
seplophobia: fear of decaying matter
sesquipedalophobia: fear of long words
sexophobia: fear of the opposite sex (heterophobia)
siderodromophobia: fear of trains, railroads or train travel
siderophobia: fear of stars
sinistrophobia: fear of things to the left or left-handed
sinophobia: fear of chinese, chinese culture
sitophobia or sitiophobia: fear of food or eating (cibophobia)
snakephobia: fear of snakes (ophidiophobia)
soceraphobia: fear of parents-in-law
social phobia: fear of being evaluated negatively in social situations
sociophobia: fear of society or people in general
somniphobia: fear of sleep
sophophobia: fear of learning
soteriophobia : fear of dependence on others
spacephobia: fear of outer space
spectrophobia: fear of specters or ghosts
spermatophobia or spermophobia: fear of germs
spheksophobia: fear of wasps
stasibasiphobia or stasiphobia: fear of standing or walking (ambulophobia)
staurophobia: fear of crosses or the crucifix
stenophobia: fear of narrow things or places
stygiophobia or stigiophobia: fear of hell
suriphobia: fear of mice
symbolophobia: fear of symbolism
symmetrophobia: fear of symmetry
syngenesophobia: fear of relatives
syphilophobia: fear of syphilis
tachophobia: fear of speed
taeniophobia or teniophobia: fear of tapeworms
taphephobia taphophobia: fear of being buried alive or of cemeteries
tapinophobia: fear of being contagious
taurophobia: fear of bulls
technophobia: fear of technology
teleophobia: 1) fear of definite plans 2) religious ceremony
telephonophobia: fear of telephones
teratophobia: fear of bearing a deformed child or fear of monsters or deformed people
testophobia: fear of taking tests
tetanophobia: fear of lockjaw, tetanus
teutophobia: fear of german or german things
textophobia: fear of certain fabrics
thaasophobia: fear of sitting
thalassophobia: fear of the sea
thanatophobia or thantophobia: fear of death or dying
theatrophobia: fear of theatres
theologicophobia: fear of theology
theophobia: fear of gods or religion
thermophobia: fear of heat
tocophobia: fear of pregnancy or childbirth
tomophobia: fear of surgical operations
tonitrophobia: fear of thunder
topophobia: fear of certain places or situations, such as stage fright
toxiphobia or toxophobia or toxicophobia: fear of poison or of being accidently poisoned
traumatophobia: fear of injury
tremophobia: fear of trembling
trichinophobia: fear of trichinosis
trichopathophobia or trichophobia: fear of hair (chaetophobia, hypertrichophobia)
triskaidekaphobia: fear of the number 13
tropophobia: fear of moving or making changes
trypanophobia: fear of injections
tuberculophobia: fear of tuberculosis
tyrannophobia: fear of tyrants
uranophobia or ouranophobia: fear of heaven
urophobia: fear of urine or urinating
vaccinophobia: fear of vaccination
venustraphobia: fear of beautiful women
verbophobia: fear of words
verminophobia: fear of germs
vestiphobia: fear of clothing
virginitiphobia: fear of rape
vitricophobia: fear of step-father
walloonphobia: fear of the walloons
wiccaphobia: fear of witches and witchcraft
xanthophobia: fear of the color yellow or the word yellow
xenoglossophobia: fear of foreign languages
xenophobia: fear of strangers or foreigners
xerophobia: fear of dryness
xylophobia: 1) fear of wooden objects 2) forests
xyrophobia:fear of razors 
zelophobia: fear of jealousy
zeusophobia: fear of god or gods
zemmiphobia: fear of the great mole rat
zoophobia: fear of animals 
